+25,25,2
222222222222222222EE22222
22222222222222222EE222222
2222222222222222EE2222222
2222222222222222E22222222
222222222222222EE22222222
222222222222222EE22222222
222222222222222EE22222222
22222222222222EE222222222
22222222222EEEEE222222222
2222222222EEEEE2222222222
2222222EEEEEEEEE222222222
222222EEEEEEEEE2222222222
2222EEEEEEEEEEEE222222222
222222EEEEEEEEE2222222222
22222222EEEE2EEEE22222222
2222222EEEE222EEE22222222
222222222EEE222EEE2222222
2222222222EEEEEEE22222222
2222222222EEEE22222222222
2222222222222222222222222
2222222222222222222222222
2222222222222222222222222
2222222222222222222222222
2222222222222222222222222
2222222222222222222222222
-
666666666666666666  66666
66666666666666666  666666
6666666666666666  6666666
6666666666666666 66666666
666666666666666  66666666
666666666666666  66666666
666666666666666  66666666
66666666666666  666666666
66666666666     666666666
6666666666     6666666666
6666666         666666666
666666         6666666666
6666            666666666
666666         6666666666
66666666    6    66666666
6666666    666   66666666
666666666   666   6666666
6666666666       66666666
6666666666    66666666666
6666666666666666666666666
6666666666666666666666666
6666666666666666666666666
6666666666666666666666666
6666666666666666666666666
6666666666666666666666666
