+25,25
666666666666666666EE66666
66666666666666666EE666666
6666666666666666EE6666666
6666666666666666E66666666
666666666666666EE66666666
666666666666666EE66666666
666666666666666EE66666666
66666666666666EE666666666
66666666666EEEEE666666666
6666666666EEEEE6666666666
6666666EEEEEEEEE666666666
666666EEEEEEEEE6666666666
6666EEEEEEEEEEEE666666666
666666EEEEEEEEE6666666666
66666666EEEE6EEEE66666666
6666666EEEE666EEE66666666
666666666EEE666EEE6666666
6666666666EEEEEEE66666666
6666666666EEEE66666666666
6666666666666666666666666
6666666666666666666666666
6666666666666666666666666
6666666666666666666666666
6666666666666666666666666
6666666666666666666666666
